1111111111111
1EC1000000001
1100011111101
1P001100CCC01
1111111111111
