111111111111111111111111111111111111111111111111111111111111111111111111
10C10000000C10C10000000C10C10000000C10C10000000C10C10000000C10C100000001
110001111110110001111110110001111110110001111110110001111110110001111111
1P0011E00000000000000000000000000000000000000000000000000000000000000001
111111111111111111111111111111111111111111111111111111111111111111111111